Help on package ttkbootstrap:

NAME
    ttkbootstrap

PACKAGE CONTENTS
    __main__
    colorutils
    constants
    dialogs (package)
    icons
    localization (package)
    publisher
    scrolled
    style
    tableview
    themes (package)
    toast
    tooltip
    utility
    validation
    widgets
    window

DATA
    ACTIVE = 'active'
    ALL = 'all'
    ANCHOR = 'anchor'
    ARC = 'arc'
    BASELINE = 'baseline'
    BEVEL = 'bevel'
    BOTH = 'both'
    BOTTOM = 'bottom'
    BROWSE = 'browse'
    BUTT = 'butt'
    CASCADE = 'cascade'
    CENTER = 'center'
    CHAR = 'char'
    CHECKBUTTON = 'checkbutton'
    CHORD = 'chord'
    COMMAND = 'command'
    CURRENT = 'current'
    DANGER = 'danger'
    DARK = 'dark'
    DEFAULT = 'default'
    DEFAULT_THEME = 'litera'
    DETERMINATE = 'determinate'
    DISABLED = 'disabled'
    DOTBOX = 'dotbox'
    E = 'e'
    END = 'end'
    EW = 'ew'
    EXTENDED = 'extended'
    FALSE = 0
    FIRST = 'first'
    FLAT = 'flat'
    FULL = 'full'
    GROOVE = 'groove'
    HEADINGS = 'headings'
    HIDDEN = 'hidden'
    HORIZONTAL = 'horizontal'
    INDETERMINATE = 'indeterminate'
    INFO = 'info'
    INSERT = 'insert'
    INSIDE = 'inside'
    INVERSE = 'inverse'
    LAST = 'last'
    LEFT = 'left'
    LIGHT = 'light'
    LINK = 'link'
    M = 3
    MITER = 'miter'
    MOVETO = 'moveto'
    MULTIPLE = 'multiple'
    N = 'n'
    NE = 'ne'
    NO = 0
    NONE = 'none'
    NORMAL = 'normal'
    NS = 'ns'
    NSEW = 'nsew'
    NUMERIC = 'numeric'
    NW = 'nw'
    OFF = 0
    ON = 1
    OUTLINE = 'outline'
    OUTSIDE = 'outside'
    PAGES = 'pages'
    PIESLICE = 'pieslice'
    PRIMARY = 'primary'
    PROJECTING = 'projecting'
    RADIOBUTTON = 'radiobutton'
    RAISED = 'raised'
    READONLY = 'readonly'
    RIDGE = 'ridge'
    RIGHT = 'right'
    ROUND = 'round'
    S = 's'
    SCROLL = 'scroll'
    SE = 'se'
    SECONDARY = 'secondary'
    SEL = 'sel'
    SEL_FIRST = 'sel.first'
    SEL_LAST = 'sel.last'
    SEMI = 'semi'
    SEPARATOR = 'separator'
    SINGLE = 'single'
    SOLID = 'solid'
    SQUARE = 'square'
    STRIPED = 'striped'
    SUCCESS = 'success'
    SUNKEN = 'sunken'
    SW = 'sw'
    TK_WIDGETS = (<class 'tkinter.Tk'>, <class 'tkinter.Toplevel'>, <class...
    TOGGLE = 'toggle'
    TOOLBUTTON = 'toolbutton'
    TOP = 'top'
    TREE = 'tree'
    TREEHEADINGS = 'tree headings'
    TRUE = 1
    TTK_ALT = 'alt'
    TTK_CLAM = 'clam'
    TTK_DEFAULT = 'default'
    TTK_WIDGETS = (<class 'tkinter.ttk.Button'>, <class 'tkinter.ttk.Check...
    UNDERLINE = 'underline'
    UNITS = 'units'
    VERTICAL = 'vertical'
    W = 'w'
    WARNING = 'warning'
    WORD = 'word'
    X = 'x'
    Y = 'y'
    YES = 1

FILE
    c:\program files\python313\lib\site-packages\ttkbootstrap\__init__.py

